XXXXXXXXXXXXXXX
              X
X   X X X X   X
X X XXXXX X   X
X XXX X XXXX  X
X     X       
XXXXXXXXXXXXX X