XXXXXXXXXXXXXXX
            X X
X   X X X X X X
X X XXXXX X   X
X XXX X XXX X X
X     X       
XXXXXXXXXXXXX X