XXXXXXXXXXXXXXXXXXXXXXXXXXXXXXXXXX
X              X
X XXXXX XXXX 
X X   X X    XX
X XXX X XXXXXXX
X     X       X
XXXXXXXXXXXXXXX